##########
#........#
#.P...o$.#
#.....#$.#
#..X...o.#
##########