######################
#........#oooo.$$$$$$#
#.P.. o$.......$$$$$.#
#.... #$.######....$.#
#..X.. o.####........#
####o########..  o...#
#.... $   ###........#
#G #.#$$  .....o....##
##.$$$$   #......o..##
######################